############
#..........#
#..#..##...#
#.#.#...#..#
#..#...#...#
#.#.#...#..#
#..#..##...#
#...t.p....#
############
