############
#........#o#
#....o.....#
#..........#
##o#.#..#.##
#.#o#p.#o#.#
#..........#
#..#..t.#..#
############
